NO ./textures/gold.xpm
SO ./textures/iron.xpm
WE ./textures/plank.xpm
EA ./textures/plank.xpm


F 110,140,120
C 110,140,120

        1111111111111111111111111
        1000000000110000000000001
        1011000001110000000000001
        1001000000000000000000001
        1111111111111111111111111
111111111011000001110000000000001
100000000011000001110111111111111
11110111111111011100000010001
11110111111111011101010010001
11000000110101011100000010001
100000000000000011000000100011
100000000000000011010100100001
11000001110101011111011110N011
11110111 1110101 101111010001
11111111 1111111 111111111111