NO ./textures/iron.xpm
SO ./textures/redstone.xpm

F 120,255,30
C 255,0,251

WE ./textures/diams.xpm
EA ./textures/plank.xpm

111111111
100000001
100000101
100000001
100000001
100000001
100000001
1N0000001
111111111
