WE ./textures/plank.xpm
NO ./textures/plank.xpm
SO ./textures/plank.xpm
EA ./textures/plank.xpm

F 24,100,25
C 40,31,17

        1111111111111111111111111      
        1000000000110000000000001
        1011000001110000000000001
        1001000000000000000000001
        1111111111111111111111111
111111111111111111111111111111111
11111111111111111111111111111
11110111111111011100000010001
111101111111110111110100100011
1100000011010101111100000010001
100000000000000011000000100011
100000000000000011010100100001
11000001110101011111011110N011
11110111 1110101 101111010001
11111111 1111111 111111111111