WE ./textures/plank.xpm
NO ./textures/plank.xpm
SO ./textures/plank.xpm
EA ./textures/plank.xpm

F 24,100,25
C 40,31,17


1111
1001
101111
101111
1011111
1000001
1000001
101N101
1001001
10000011
11111111