NO ./textures/wall_1/north.png
SO ./textures/wall_1/south.png

F 120,255,30
C 255,120,251

WE ./textures/wall_1/west.png
EA ./textures/wall_1/east.png

111111111
100000001
100000101
100000001
100000001
100000001
100000001
1N0000001
111111111
